##################
#                #
#                #
#                #
#                #
#                #
#                #
#        a       #
# @  @           #
##################
