##########
#        #
#        #
#        #
#   a    #
#   b    #
#        #
#   @    #
#       @#
##########
