######################
#                    #
#                 1 #
#                    #
#                    #
#                    #
#                    #
# b                  #
#                    #
#         @          #
#                    #
#                    #
#        @           #
#                    #
#                    #
#                    #
#                    #
#                    #
#                    #
# 2                  #
#                    #
######################
