######################
#                    #
#                  1 #
#                  @ #
#                    #
#                    #
#                    #
#                   #
#                  k #
#                    #
#                    #
#                    #
#                    #
#            @       #
#                    #
#                    #
#                    #
#                    #
#                    #
# 2                  #
#                    #
######################
