##########
#        #
#     a  #
#       @#
#        #
#        #
#     b  #
#        #
#   @    #
##########
