###########################
#                         #
#                         #
#                         #
#                         #
#                         #
#                    @    #
#          b              #
#                         #
#                         #
#         a               #
#                         #
#                         #
#                        @#
#                         #
#                         #
#                         #
#                         #
#                         #
#                         #
#                         #
#                         #
#                         #
#                         #
#                      @  #
#            @            #
###########################
