######################
#                   1#
#                    #
#                    #
#                    #
#                    #
#                    #
#                    #
#                    #
#                    #
#                   #
#                    #
#                    #
#                    #
#                    #
#                    #
#                    #
#                    #
#                    #
#                    #
#2                   #
######################
