###########################
#                         #
#                       1 #
#                         #
#                         #
#                         #
#                      @  #
#                         #
#                         #
#                         #
#                         #
#                         #
#                         #
#                         #
#                         #
#                        a#
#                         #
#                         #
#                         #
#                        @#
#                         #
#                         #
#                         #
#                         #
# 2                    b  #
#                         #
###########################
