##########
#        #
#        #
#    a   #
#        #
#    b   #
#        #
#@   @   #
#        #
##########
